R 2021 1021
NO ./yes
SO ./here
WE ./there
EA ./lol

11111111111111111111111
10000000000000000000001
10000000111110000000001
10000010000000000000001
10001110000000000000001
10011000000000000000001
10000000000000000000001
10000000000000000000001
10000000000000000000001
10000000000000000000001
10000000000000000000001
10000000000000000000001
10000000000000000000001
10000000000000000000001
10000000000000000000001
10000000000000000000001
10000000000000000000001
10000000000000000000001
10000000000000000000001
10000000000000000000001
10000000000000000000001
11111111111111111111111
