R 2021 1000

NO   ./xpms/greystone.xpm
SO  ./xpms/redbrick.xpm
WE   ./xpms/colorstone.xpm
EA  ./xpms/wood.xpm
S    ./xpms/pillar.xpm

F  17,120,100
C  133,193,233

1111111
111W111
1111111