R 1021 812

111111111111111111111111
100000000000000000000001
100000000000000000000001
100000000000000000000001
100000000000001001001001
100000000000000000000001
100000000000000100001001
100000000000000000000001
100000000000001001001001
100000000000000000000001
100000000000000000000001
100000000000000000000001
100000000000000000000001
100000000000000000000001
100000000000000000000001
100000000000000000000001
111111111000000000000001
110100001000000000000001
110000001000000000000001
110100001000000000000001
110111111000000000000001
110000000000000000000001
111111111000000000000001
111111111111111111111111
