R 500 500
NO  ./xpms/colorstone.xpm
SO  ./xpms/redbrick.xpm
EA  ./xpms/wood.xpm
WE ./xpms/colorstone.xpm
S    ./xpms/small.xpm
F  17,120,100
C  133,193,250

111111111111111 
100000020000001
100000000111111
100000000000001
1000011100000001
100011000S000001
100000000000001
100000011111111
101100000000001
100000011111111
100000000000001
1000000000000011111111
100000000000001
10000000000001
111111111111111

