R 1021 812

11111 111111111111111111
10001 100000000001111111
10001 100000000001
10001 100000000001111111
100011100000001001001001
100000000000000000000001
100000000000000100001001
100000000000000000000001
100000000000001001001001
100000000000000000000001
111111100000000000000001
      100000000000000001
111111100000000000000001
100000000000000000000001
100000000000000000000001
100000000000000000000001
111111111000000000000001
110100001000000000000001
110000001000000000000001
110100001000000011100001
11011111100000001 100001
11000000000000001 100001
11111111100000001 100001
11111111111111111 111111
