R 1500  750

NO  ./xpms/greystone.xpm

SO  ./xpms/redbrick.xpm
WE   ./xpms/colorstone.xpm

EA  ./xpms/wood.xpm

S    ./xpms/pillar.xpm

F  -17,120,100
C  133,193,233

111111111111111 111
100000000000001 101
100000001000001 101
1000000000N0001 101
111111111111111 111

1111110