R 2021 1021

NO ./xpms/greystone.xpm
SO ./xpms/redbrick.xpm
WE  ./xpms/colorstone.xpm
EA ./xpms/wood.xpm
S ./xpms/pillar.xpm

F  17,120,100
C  133,193,233

111111111111111111111111
100000010000000000000001
100000010000000000000001
100000010000000000000001
100000001000000000000001
100000010000000000000001
100000010000000000000001
100000000000000000000001
111111111111111111111111
