R 1021 812

111111111111111111111111
100000000000000000000001
100000000000000000000001
100000000000000000000001
100000222220000101010001
100000200020000000000001
100000200020000100010001
100000200020000000000001
100000220220000101010001
100000000000000000000001
100000000000000000000001
100000000000000000000001
100000000000000000000001
100000000000000000000001
100000000000000000000001
100000000000000000000001
111111111000000000000001
110100001000000000000001
110000501000000000000001
110100001000000000000001
110111111000000000000001
110000000000000000000001
111111111000000000000001
111111111111111111111111
