R 2021 1000

NO   ./xpms/greystone.xpm
SO  ./xpms/redbrick.xpm
WE   ./xpms/colorstone.xpm
EA  ./xpms/wood.xpm
S    ./xpms/pillar.xpm

F  17,120,100
C  133,193,233

111111111111111
100000N00000001
100000000000001
101000000000001
100100000000001
100011000000001
100000000000001
111111111111111