R 2021 1021

NO ./xpms/greystone.xpm
SO ./xpms/redbrick.xpm
WE  ./xpms/colorstone.xpm
EA ./xpms/wood.xpm
S ./xpms/pillar.xpm

F  17,120,100
C  133,193,233

11111111111111111111111
10000200000000000000001
10000000111110000000001
10000010000000000000001
10001110000000000000001
10011000000000000000001
10000000000000000000001
10000000000000000000001
10010000000000000000001
10010000000000000000001
10010000000000000000001
10011011100000000000001
10010000000000000000001
10010000000000000000001
10000000000000000000001
10000000000000000000001
10000000000000000000001
10000000000000000000001
10000000000000000000001
10000000000000000000001
10000000000000000000001
11111111111111111111111
