R 2021 1021

NO   ./xpms/greystone.xpm
SO  ./xpms/redbrick.xpm
WE   ./xpms/colorstone.xpm
EA  ./xpms/wood.xpm
S    ./xpms/pillar.xpm

F  17,120,100
C  133,193,233

1111111
111W
1111111