R 500  500
NO  ./xpms/frog.xpm
SO  ./xpms/redbrick.xpm
WE   ./xpms/colorstone.xpm
EA  ./xpms/wood.xpm
S    ./xpms/pillar.xpm
F  17,120,100
C  133,193,233

111111111111111 
100000000000001
100000000000001
100000000000001
100000000000001
100000000000001
100000000000001
100000000000001
100000000000001
100000000000001
100000000000001
100000000000001
100000000000001
100000000000001
100000000000001
100000000000001
100000000000001
100000000000001
100000000000001
100000000000001
100000000000001
100000000000001
100000000000001
100000000000001
100000000000001
100000000000001
100000000000001
100000000000001
100000000000001
100000000000001
100000000000001
100000000000001
100000000000001
100000000000001
100000000000001
100000000000001
100000000000001
100000000000001
100000000000001
100000000000001
100000000000001
100000000000001
100000000000001
100000000000001
100000000000001
100000000000001
100000000000001
100000000000001
100000000000001
100000000000001
100000000000001
100000000000001
100000000000001
100000000000001
100000200000001
100000000000001
100000000000001
100000200000001
100000000000001
100000000000001
100000000000001
102220000000001
100000000200001
100000000200001
100000000200001
100002000000001
100000001000001
1000000000S0001
111111111111111

