R     1000 1000
NO  ./xpms/greystone.xpm
SO  ./xpms/greystone.xpm
EA  ./xpms/greystone.xpm
WE ./xpms/greystone.xpm
S    ./xpms/small.xpm


F  0,0,0 
C  255,255,255

1111111111
1000000S1
111111111