R     1000 1000
NO  ./xpms/greystone.xpm
SO  ./xpms/greystone.xpm
EA  ./xpms/greystone.xpm
WE ./xpms/greystone.xpm
S    ./xpms/small.xpm
F  0,0,0 
C  255,255,255




1111111111
100111101111
12000S001
100000001
100000001
100000001
100000001
100000001
100000001
100000001
100000001
100000001
100011111
10001
100011111
100000001
100000001
122222221
1111111111